abaissed: beschämt
accusant: ankläger
accusers: ankläger
acinaces: stacheln
annalist: chronist
anodally: anodisch
appulses: pulsiert
artistes: künstler
backwall: rückwand
bakeress: bäckerin
bandsawn: bandsäge
batteuse: schläger
beatster: schlager
bemuzzle: maulkorb
beshames: beschämt
bevilled: beschämt
blowhole: atemloch
boiserie: täfelung
bordured: umrandet
bournous: brünstig
bruisers: schläger
caitiffs: schurken
caterers: catering
cetaceum: walfisch
cherries: kirschen
chilling: abkühlen
cindered: verkohlt
cleavage: spaltung
coachman: kutscher
colloquy: gespräch
credenda: anrichte
crescent: halbmond
crewneck: rundhals
crociary: kroatien
dampened: gedämpft
dangling: baumelnd
deludher: täuschen
discinct: deutlich
doodling: kritzeln
duchesse: herzogin
eyeballs: augäpfel
elseways: anderswo
englante: englisch
enlinked: verlinkt
erasable: löschbar
erotetic: erotisch
estimate: schätzen
exotoxic: exotisch
featness: leistung
fizzling: zischend
forgoing: verzicht
formwork: schalung
fourfold: vierfach
gastight: gasdicht
gaussian: gaußsche
gladless: freudlos
glancing: flüchtig
guiltful: schuldig
gunating: spritzen
headrace: oberlauf
iambical: jambisch
idleness: faulheit
yellowed: vergilbt
intially: zunächst
jiggered: wackelig
kittened: kätzchen
knapping: schlagen
lectress: lektorin
licorice: lakritze
lienable: pfändbar
liveried: lackiert
lucrific: lukrativ
mainland: festland
mainmast: großmast
makeress: macherin
mascally: maskulin
moraller: moralist
morelles: morcheln
muckerer: mistkerl
musseler: muscheln
northern: nördlich
nutating: taumelnd
nuzzling: kuscheln
obeyable: gehorsam
outrogue: empörung
overrake: überlauf
overruff: überlauf
pampered: verwöhnt
passback: rücklauf
passbook: sparbuch
peccable: sündhaft
perpends: aufrecht
pittings: lochfraß
playable: spielbar
plunging: stürzend
poetless: poetisch
pregrade: vorstufe
preluder: vorspiel
prepuces: vorhäute
pretexts: vorwände
prodroma: vorstufe
proterve: schützen
pruritus: juckreiz
puckerer: runzelig
quadrual: vierfach
quipping: witzelnd
quitting: aufhören
racketer: schläger
ransacks: plündert
raquette: schläger
recolour: umfärben
recovery: erholung
redbelly: rotbauch
richesse: reichtum
rousters: rüstzeug
rudeness: grobheit
ruefully: reumütig
salifies: versalzt
sambucus: holunder
saporous: fruchtig
sawtooth: sägezahn
scalados: skaliert
scalages: skaliert
scolopes: schaufel
scrieves: schreibt
scrooges: geizhals
scunners: schurken
serratus: sägezahn
shirring: kräuseln
shooters: schützen
shrewder: schlauer
shrewish: zänkisch
sibilous: zischend
sighting: sichtung
slakable: löschbar
sluggers: schläger
slushily: matschig
snuggles: kuschelt
solariia: solarium
staggard: taumelnd
surcease: aufhören
swabbies: schwaben
swilling: säubernd
swirring: wirbelnd
tarragon: estragon
tirement: ermüdung
toilless: mühselig
towerlet: türmchen
tripping: stolpern
trippler: dreifach
trithing: dreifach
troopers: soldaten
trussery: fachwerk
undaubed: unbemalt
unfoully: unflätig
unjaunty: unflätig
unmember: auflösen
unmuzzle: maulkorb
unsecure: unsicher
unsupped: ungesüßt
upthrust: auftrieb
usefully: nützlich
venisons: wildbret
vesicles: bläschen
westaway: westlich
whooshed: rauschte
widdling: wispernd
